20
15
4 4 4 4 4 4 4 4 4 4 4 4 4 4 4 4 4 4 4 4
4 1 2 1 1 2 1 1 1 1 1 1 1 1 0 3 3 0 1 4
4 1 2 2 2 2 1 1 0 1 1 0 1 1 0 1 1 0 1 4
4 1 0 1 1 0 1 1 0 1 2 0 1 1 0 1 1 0 1 4
4 1 1 1 1 1 1 1 0 2 1 0 1 1 1 1 1 1 1 4
4 1 0 1 1 0 1 1 1 1 1 1 1 1 0 1 1 0 1 4
4 1 1 1 1 1 1 1 3 3 3 3 1 1 1 1 1 1 1 4
4 1 1 2 2 1 1 1 3 3 3 3 1 1 1 2 2 1 1 4
4 1 1 1 1 1 1 1 3 3 3 3 1 1 1 1 1 1 1 4
4 1 0 1 1 0 1 1 1 1 1 1 1 1 0 1 1 0 1 4
4 1 1 1 1 1 1 1 0 2 1 0 1 1 1 1 1 1 1 4
4 1 0 1 1 0 1 1 0 1 2 0 1 1 0 1 1 0 1 4
4 1 0 1 1 0 1 1 0 1 1 0 1 1 2 2 2 2 1 4
4 1 0 3 3 0 1 1 1 1 1 1 1 1 2 1 1 2 1 4
4 4 4 4 4 4 4 4 4 4 4 4 4 4 4 4 4 4 4 4 